CMM72222+22
CQC52222+22
CH9J2222+22
9H9M2222+22
8PQ42222+22
9P4G2222+22
8Q572222+22
